"report_date","previous_day_total_doses_administered","previous_day_at_least_one","previous_day_fully_vaccinated","previous_day_3doses","total_doses_administered","total_individuals_at_least_one","total_individuals_partially_vaccinated","total_doses_in_fully_vaccinated_individuals","total_individuals_fully_vaccinated","total_individuals_3doses"
2021-01-01,6251,6241,2,,32188,32133,32122,22,11,
2021-01-02,4613,4601,6,,36801,36682,36669,26,13,
2021-01-03,5393,5386,3,,42194,42068,42052,32,16,
2021-01-04,5994,5992,0,,48188,48059,48044,30,15,
2021-01-05,9681,9657,19,,57869,57714,57681,66,33,
2021-01-06,12792,12327,450,,70661,70037,69558,958,479,
2021-01-07,16217,15505,697,,86878,85541,84365,2352,1176,
2021-01-08,18037,17022,1002,,104915,102563,100385,4356,2178,
2021-01-09,19499,18422,1064,,124414,120984,117742,6484,3242,
2021-01-10,11369,11330,37,,135783,132305,129027,6556,3278,
2021-01-11,11710,11661,48,,147493,143966,140640,6652,3326,
2021-01-12,14467,14160,298,,161960,158118,154494,7248,3624,
2021-01-13,15435,13813,1593,,177395,171917,166702,10430,5215,
2021-01-14,19181,16730,2436,,196576,188641,180991,15300,7650,
2021-01-15,20046,17990,2037,,216622,206620,196933,19374,9687,
2021-01-16,17115,15932,1170,,233737,222536,211679,21714,10857,
2021-01-17,11255,10012,1236,,244992,232533,220442,24182,12091,
2021-01-18,6792,6710,72,,251784,239220,227060,24320,12160,
2021-01-19,11824,9716,2094,,263608,248915,234661,28508,14254,
2021-01-20,10799,7210,3572,,274407,256102,238277,35650,17825,
2021-01-21,10968,6850,4091,,285375,262936,241020,43832,21916,
2021-01-22,9037,4320,4698,,294412,267219,240607,53224,26612,
2021-01-23,7447,3031,4388,,301859,270220,239221,61998,30999,
2021-01-24,4381,1825,2536,,306240,272027,238492,67070,33535,
2021-01-25,5318,1046,4263,,311558,273041,235244,75594,37797,
2021-01-26,9382,2859,6495,,320940,275868,231577,88582,44291,
2021-01-27,9893,2861,7004,,330833,278700,227406,102588,51294,
2021-01-28,13107,5732,7333,,343940,284399,225772,117254,58627,
2021-01-29,10684,3271,7379,,354624,287639,221634,132010,66005,
2021-01-30,9185,2726,6422,,363809,290323,217899,144848,72424,
2021-01-31,3372,1560,1767,,367181,291849,217659,148380,74190,
2021-02-01,2121,484,1609,,369302,292299,216504,151590,75795,
2021-02-02,4405,1352,2995,,373707,293613,214827,157572,78786,
2021-02-03,6232,1712,4458,,379939,295284,212047,166474,83237,
2021-02-04,9073,1705,7289,,389012,296946,206426,181040,90520,
2021-02-05,8439,1465,6903,,397451,298371,200954,194834,97417,
2021-02-06,10656,1862,8735,,408107,300178,194035,212286,106143,
2021-02-07,7569,1725,5796,,415676,301863,189936,223854,111927,
2021-02-08,8215,3093,5080,,423891,304908,187914,233988,116994,
2021-02-09,14997,3851,11079,,438888,308717,180660,256114,128057,
2021-02-10,15502,4924,10518,,454390,313589,175039,277100,138550,
2021-02-11,16359,3896,12407,,470749,317433,166507,301852,150926,
2021-02-12,17649,2094,15505,,488398,319489,153077,332824,166412,
2021-02-13,16200,2438,13746,,504598,321882,141743,360278,180139,
2021-02-14,12874,917,11925,,517472,322751,130717,384068,192034,
2021-02-15,7859,483,7328,,525331,323186,123850,398672,199336,
2021-02-16,5990,1040,4900,,531321,324183,119970,408426,204213,
2021-02-17,10160,1604,8522,,541481,325743,113036,425414,212707,
2021-02-18,13866,2952,10870,,555347,328647,105100,447094,223547,
2021-02-19,18486,6212,12207,,573833,334807,99084,471446,235723,
2021-02-20,22621,11129,11440,,596454,345873,98748,494250,247125,
2021-02-21,17232,10377,6821,,613686,356190,102286,507808,253904,
2021-02-22,13576,8750,4775,,627262,364870,106241,517258,258629,
2021-02-23,17855,11119,6665,,645117,375933,110675,530516,265258,
2021-02-24,18564,13605,4878,,663681,389482,119388,540188,270094,
2021-02-25,20801,16485,4259,,684482,405901,131596,548610,274305,
2021-02-26,24882,21827,2995,,709364,427668,150405,554526,277263,
2021-02-27,27449,23573,3835,,736813,451177,170127,562100,281050,
2021-02-28,20578,19139,1405,,757391,470262,187849,564826,282413,
2021-03-01,18214,17021,1148,,775605,487221,203707,567028,283514,
2021-03-02,24672,22269,2319,,800277,509429,223642,571574,285787,
2021-03-03,30584,27955,2576,,830861,537333,249003,576660,288330,
2021-03-04,34679,32453,2142,,865540,569720,279298,580844,290422,
2021-03-05,39976,38148,1780,,905516,607820,315652,584336,292168,
2021-03-06,44135,41933,2164,,949651,649698,355407,588582,294291,
2021-03-07,32726,31549,1173,,982377,681173,385767,590812,295406,
2021-03-08,24035,22161,1861,,1006412,703266,406053,594426,297213,
2021-03-09,33277,29830,3419,,1039689,733030,432444,601172,300586,
2021-03-10,38320,34061,4214,,1078009,767017,462265,609504,304752,
2021-03-11,43964,40693,3232,,1121973,807644,499712,615864,307932,
2021-03-12,47692,45980,1688,,1169665,853560,543990,619140,309570,
2021-03-13,57897,55026,2843,,1227562,908515,596156,624718,312359,
2021-03-14,43395,42161,1217,,1270957,950593,637085,627016,313508,
2021-03-15,32796,31100,1681,,1303753,981634,666488,630292,315146,
2021-03-16,53935,51643,2276,,1357688,1033212,715833,634758,317379,
2021-03-17,61049,58514,2492,,1418737,1091660,771839,639642,319821,
2021-03-18,61520,59067,2428,,1480257,1150655,828459,644392,322196,
2021-03-19,64449,61128,3268,,1544706,1211705,886294,650822,325411,
2021-03-20,62552,59966,2555,,1607258,1271615,943697,655836,327918,
2021-03-21,43981,42462,1533,,1651239,1314012,984598,658828,329414,
2021-03-22,30989,30027,973,,1682228,1343951,1013620,660662,330331,
2021-03-23,54600,51825,2724,,1736828,1395681,1062689,665984,332992,
2021-03-24,76409,73229,3132,,1813237,1468820,1132753,672134,336067,
2021-03-25,82897,80318,2532,,1896134,1549059,1210517,677084,338542,
2021-03-26,86985,83456,3490,,1983119,1632434,1290454,683960,341980,
2021-03-27,80834,77886,2864,,2063953,1710217,1365438,689558,344779,
2021-03-28,66981,65395,1553,,2130934,1775522,1429247,692550,346275,
2021-03-29,51725,49040,2651,,2182659,1824482,1475602,697760,348880,
2021-03-30,73559,70154,3347,,2256218,1894559,1542373,704372,352186,
2021-03-31,93138,89494,3577,,2349356,1983955,1628245,711420,355710,
2021-04-01,89294,85424,3833,,2438650,2069281,1709791,718980,359490,
2021-04-02,93065,88843,4206,,2531715,2158038,1794394,727288,363644,
2021-04-03,60984,59313,1729,,2592699,2217260,1851938,730644,365322,
2021-04-04,72323,70673,1646,,2665022,2287822,1920912,733820,366910,
2021-04-05,53725,53256,469,,2718747,2340994,1973663,734662,367331,
2021-04-06,79568,77705,1883,,2798315,2418598,2049437,738322,369161,
2021-04-07,107992,104931,3053,,2906307,2523404,2151248,744312,372156,
2021-04-08,114060,110097,4020,,3020367,2633390,2257270,752240,376120,
2021-04-09,109824,105608,4290,,3130191,2738880,2358535,760690,380345,
2021-04-10,109218,105468,3843,,3239409,2844220,2460098,768244,384122,
2021-04-11,98609,95499,3254,,3338018,2939594,2552277,774634,387317,
2021-04-12,76057,74996,1154,,3414075,3014442,2626039,776806,388403,
2021-04-13,99452,96079,3395,,3513527,3110412,2718662,783500,391750,
2021-04-14,117029,113271,3647,,3630556,3223565,2828208,790714,395357,
2021-04-15,113547,109495,3894,,3744103,3332934,2933740,798388,399194,
2021-04-16,118092,113723,4191,,3862195,3446547,3043206,806682,403341,
2021-04-17,112398,107816,4443,,3974593,3554229,3146504,815450,407725,
2021-04-18,88729,86498,2099,,4063322,3640604,3230834,819540,409770,
2021-04-19,68958,67432,1447,,4132280,3707906,3296740,822332,411166,
2021-04-20,101905,98586,3115,,4234185,3806330,3392114,828432,414216,
2021-04-21,141977,137713,4030,,4376162,3943869,3525691,836356,418178,
2021-04-22,139456,135317,3901,,4515618,4079057,3657034,844046,422023,
2021-04-23,138183,131785,6155,,4653801,4210688,3782568,856240,428120,
2021-04-24,130268,126217,3880,,4784069,4336757,3904813,863888,431944,
2021-04-25,102003,98601,3174,,4886072,4435210,4000159,870102,435051,
2021-04-26,70996,69294,1555,,4957068,4504373,4067827,873092,436546,
2021-04-27,98482,95411,2882,,5055550,4599623,4160258,878730,439365,
2021-04-28,120557,115943,4424,,5176107,4715398,4271681,887434,443717,
2021-04-29,124464,119275,5044,,5300571,4834506,4385814,897384,448692,
2021-04-30,115793,110553,5005,,5416364,4944886,4491266,907240,453620,
2021-05-01,111267,107416,3636,,5527631,5052121,4594942,914358,457179,
2021-05-02,79124,76153,2859,,5606755,5128117,4668145,919944,459972,
2021-05-03,56780,55115,1593,,5663535,5183077,4721572,923010,461505,
2021-05-04,91913,88546,3281,,5755448,5271445,4806736,929418,464709,
2021-05-05,137975,133277,4614,,5893423,5404553,4935293,938520,469260,
2021-05-06,141823,136873,4813,,6035246,5541242,5067231,948022,474011,
2021-05-07,150253,145226,4828,,6185499,5686308,5207528,957560,478780,
2021-05-08,142436,137758,4430,,6327935,5823871,5340740,966262,483131,
2021-05-09,124786,121142,3477,,6452721,5944849,5458305,973088,486544,
2021-05-10,97789,95814,1875,,6550510,6040474,5552122,976704,488352,
2021-05-11,113501,108840,4484,,6664011,6149112,5656347,985530,492765,
2021-05-12,145014,137998,6870,,6809025,6286931,5787362,999138,499569,
2021-05-13,142644,135298,7200,,6951669,6422054,5915359,1013390,506695,
2021-05-14,148856,138758,9930,,7100525,6560624,6044064,1033120,516560,
2021-05-15,159701,149669,9855,,7260226,6710106,6183766,1052680,526340,
2021-05-16,144341,136076,8061,,7404567,6846014,6311693,1068642,534321,
2021-05-17,114959,110864,3942,,7519526,6956689,6418502,1076374,538187,
2021-05-18,111294,100439,10655,,7630820,7056932,6508152,1097560,548780,
2021-05-19,149850,133450,16224,,7780670,7190230,6625300,1129860,564930,
2021-05-20,151535,131554,19769,,7932205,7321595,6736965,1169260,584630,
2021-05-21,165350,140856,24239,,8097555,7462270,6853478,1217584,608792,
2021-05-22,199397,172218,26953,,8296952,7634291,6998627,1271328,635664,
2021-05-23,139807,127441,12222,,8436759,7761554,7113730,1295648,647824,
2021-05-24,100281,93311,6825,,8537040,7854692,7200113,1309158,654579,
2021-05-25,90432,82953,7271,,8627472,7937482,7275699,1323566,661783,
2021-05-26,139747,112985,26498,,8767219,8050280,7362069,1376422,688211,
2021-05-27,152040,123024,28764,,8919259,8173147,7456241,1433812,716906,
2021-05-28,163833,132285,31242,,9083092,8305259,7557170,1496178,748089,
2021-05-29,153354,117101,36021,,9236446,8422211,7638157,1568108,784054,
2021-05-30,149696,119000,30472,,9386142,8541041,7726577,1628928,814464,
2021-05-31,99193,79800,19202,,9485335,8620671,7787069,1667204,833602,
2021-06-01,124162,90590,33238,,9609497,8711066,7844301,1733530,866765,
2021-06-02,145275,102122,42905,,9754772,8813007,7903406,1819202,909601,
2021-06-03,155328,99888,55163,,9910100,8912711,7948018,1929386,964693,
2021-06-04,181682,115514,65900,,10091782,9028026,7997521,2061010,1030505,
2021-06-05,171981,103405,68301,,10263763,9131233,8032512,2197442,1098721,
2021-06-06,163359,91840,71239,,10427122,9222895,8053005,2339780,1169890,
2021-06-07,119547,63040,56290,,10546669,9285738,8059633,2452210,1226105,
2021-06-08,161870,72431,89002,,10708539,9357980,8042953,2630054,1315027,
2021-06-09,181437,70789,110184,,10889976,9428592,8003462,2850260,1425130,
2021-06-10,185551,66406,118658,,11075527,9494795,7951098,3087394,1543697,
2021-06-11,204753,67497,136504,,11280280,9562106,7881987,3360238,1680119,
2021-06-12,199694,62652,136445,,11479974,9624576,7808104,3632944,1816472,
2021-06-13,190302,58863,130913,,11670276,9683264,7735959,3894610,1947305,
2021-06-14,137672,38685,98593,,11807948,9721753,7675960,4091586,2045793,
2021-06-15,189184,42586,146248,,11997132,9764121,7572177,4383888,2191944,
2021-06-16,206103,42418,163045,,12203235,9806343,7451457,4709772,2354886,
2021-06-17,210380,37919,171884,,12413615,9844047,7317369,5053356,2526678,
2021-06-18,217120,35340,181179,,12630735,9879197,7171432,5415530,2707765,
2021-06-19,215837,35477,179692,,12846572,9914468,7027123,5774690,2887345,
2021-06-20,186237,35545,150117,,13032809,9949815,6912461,6074708,3037354,
2021-06-21,120414,20818,99099,,13153223,9970438,6834077,6272722,3136361,
2021-06-22,204896,27488,176657,,13358119,9997732,6684823,6625818,3312909,
2021-06-23,230491,28612,201144,,13588610,10026144,6512199,7027890,3513945,
2021-06-24,227656,26662,200246,,13816266,10052610,6338529,7428162,3714081,
2021-06-25,251074,27962,222368,,14067340,10080371,6144040,7872662,3936331,
2021-06-26,261257,29990,230566,,14328597,10110136,5943379,8333514,4166757,
2021-06-27,204975,27776,176597,,14533572,10137730,5794486,8686488,4343244,
2021-06-28,199232,20950,177724,,14732804,10158482,5637639,9041686,4520843,
2021-06-29,250089,24482,224880,,14982893,10182723,5437154,9491138,4745569,
2021-06-30,275510,24165,250780,,15258403,10206685,5210465,9992440,4996220,
2021-07-01,271949,25296,246102,,15530352,10231763,4989580,10484366,5242183,
2021-07-02,144704,11580,132900,,15675056,10243169,4868188,10749962,5374981,
2021-07-03,216874,19919,196723,,15891930,10262866,4691311,11143110,5571555,
2021-07-04,196141,19397,176522,,16088071,10282077,4534119,11495916,5747958,
2021-07-05,148708,12436,136130,,16236779,10294324,4410363,11767922,5883961,
2021-07-06,220004,19982,199809,,16456783,10314090,4230466,12167248,6083624,
2021-07-07,246593,22961,223392,,16703376,10336825,4029957,12613736,6306868,
2021-07-08,231179,21342,209628,,16934555,10357961,3841600,13032722,6516361,
2021-07-09,226968,21498,205304,,17161523,10379257,3657724,13443066,6721533,
2021-07-10,209044,20533,188358,,17370567,10399586,3489832,13819508,6909754,
2021-07-11,171648,17565,153958,,17542215,10416950,3353385,14127130,7063565,
2021-07-12,123116,11441,111579,,17665331,10428202,3253195,14350014,7175007,
2021-07-13,178464,19015,159307,,17843795,10446995,3112836,14668318,7334159,
2021-07-14,180012,19293,160563,,18023807,10466073,2971514,14989118,7494559,
2021-07-15,167171,19578,147421,,18190978,10485440,2843624,15283632,7641816,
2021-07-16,169317,19885,149280,,18360295,10505123,2714180,15581886,7790943,
2021-07-17,172971,20252,152594,,18533266,10525126,2581781,15886690,7943345,
2021-07-18,133609,15919,117551,,18666875,10540861,2480113,16121496,8060748,
2021-07-19,91960,10410,81443,,18758835,10551058,2409042,16284032,8142016,
2021-07-20,133514,16937,116519,,18892349,10567755,2309396,16516718,8258359,
2021-07-21,140066,16976,123020,,19032415,10584516,2203299,16762434,8381217,
2021-07-22,125573,17625,107814,,19157988,10601917,2113063,16977708,8488854,
2021-07-23,120235,16979,103050,,19278223,10618655,2026950,17183410,8591705,
2021-07-24,126668,18323,108108,,19404891,10636775,1937125,17399300,8699650,
2021-07-25,103613,14851,88634,,19508504,10651402,1863299,17576206,8788103,
2021-07-26,66672,9880,56700,,19575176,10661064,1816442,17689244,8844622,
2021-07-27,92355,15312,76882,,19667531,10676115,1754828,17842574,8921287,
2021-07-28,93906,16443,77387,,19761437,10692323,1693840,17996966,8998483,
2021-07-29,89369,16692,72514,,19850806,10708783,1637974,18141618,9070809,
2021-07-30,84027,16088,67826,,19934833,10724643,1586196,18276894,9138447,
2021-07-31,83813,15693,67968,,20018646,10740118,1533893,18412450,9206225,
2021-08-01,61848,11306,50361,,20080494,10751198,1494803,18512790,9256395,
2021-08-02,42463,7400,34945,,20122957,10758400,1467226,18582348,9291174,
2021-08-03,33265,5945,27152,,20156222,10764112,1445996,18636232,9318116,
2021-08-04,61290,12359,48739,,20217512,10776236,1409579,18733314,9366657,
2021-08-05,59420,12524,46742,,20276932,10788552,1375317,18826470,9413235,
2021-08-06,55992,11842,43934,,20332924,10800134,1343194,18913880,9456940,
2021-08-07,62343,12118,50029,,20395267,10811991,1305240,19013502,9506751,
2021-08-08,48645,9247,39211,,20443912,10821010,1275253,19091514,9545757,
2021-08-09,30837,5929,24735,,20474749,10826725,1256420,19140610,9570305,
2021-08-10,49221,10493,38430,,20523970,10836938,1228449,19216978,9608489,
2021-08-11,48698,10757,37700,,20572668,10847448,1201475,19291946,9645973,
2021-08-12,49212,11180,37807,,20621880,10858377,1174806,19367142,9683571,
2021-08-13,49592,11716,37603,,20671472,10869852,1148889,19441926,9720963,
2021-08-14,51189,12121,38860,,20722661,10881723,1122124,19519198,9759599,
2021-08-15,41733,9837,31676,,20764394,10891358,1100255,19582206,9791103,
2021-08-16,26717,6172,20390,,20791111,10897307,1086011,19622592,9811296,
2021-08-17,40476,11044,29170,,20831587,10908101,1067861,19680480,9840240,
2021-08-18,41871,11956,29675,,20873458,10919815,1050110,19739410,9869705,
2021-08-19,45860,16513,29086,,20919318,10936077,1037509,19797136,9898568,
2021-08-20,46405,16269,29722,,20965723,10952090,1024029,19856122,9928061,
2021-08-21,47928,15136,32423,,21013651,10966966,1006709,19920514,9960257,
2021-08-22,34366,10797,23302,,21048017,10977517,994180,19966674,9983337,
2021-08-23,23214,7002,15996,,21071231,10984284,985165,19998238,9999119,
2021-08-24,37627,13359,23812,,21108858,10997389,974689,20045400,10022700,
2021-08-25,41303,14399,26299,,21150161,11011532,962770,20097524,10048762,
2021-08-26,39245,13548,24955,,21189406,11024804,951328,20146952,10073476,
2021-08-27,37634,12917,23674,,21227040,11037480,940544,20193872,10096936,
2021-08-28,40082,13407,25501,,21267122,11050609,928426,20244366,10122183,
2021-08-29,30521,10234,19932,,21297643,11060611,918709,20283804,10141902,
2021-08-30,18225,6136,11840,,21315868,11066499,912976,20307046,10153523,
2021-08-31,32690,11930,19611,,21348558,11078161,905267,20345788,10172894,
2021-09-01,36213,12933,21936,,21384771,11090861,896248,20389226,10194613,
2021-09-02,37740,15631,19650,,21422511,11106240,892204,20428072,10214036,
2021-09-03,46837,21066,22423,,21469348,11127058,890828,20472460,10236230,
2021-09-04,46851,20579,24760,,21516199,11147391,886624,20521534,10260767,
2021-09-05,33049,14198,18565,,21549248,11161345,882237,20558216,10279108,
2021-09-06,21690,9478,12025,,21570938,11170574,879673,20581802,10290901,
2021-09-07,14975,6714,8079,,21585913,11177031,878291,20597480,10298740,
2021-09-08,41117,17101,20923,,21627030,11193868,874451,20638834,10319417,
2021-09-09,41424,16965,19663,,21668454,11210556,871728,20677656,10338828,
2021-09-10,39609,15496,18980,,21708063,11225790,868226,20715128,10357564,
2021-09-11,42349,15926,23323,,21750412,11241437,860808,20761258,10380629,
2021-09-12,29943,11525,17858,,21780355,11252668,854445,20796446,10398223,
2021-09-13,16065,6397,9172,,21796420,11258831,851655,20814352,10407176,
2021-09-14,29881,11551,15278,,21826301,11270081,847901,20844360,10422180,
2021-09-15,39253,14013,19410,,21865554,11283835,842489,20882692,10441346,
2021-09-16,39324,13974,19236,,21904878,11297574,837204,20920740,10460370,
2021-09-17,38897,13598,19321,,21943775,11310929,831469,20958920,10479460,
2021-09-18,41197,14074,23502,,21984972,11324730,822020,21005420,10502710,
2021-09-19,30636,10822,18970,,22015608,11335293,813859,21042868,10521434,
2021-09-20,16723,6100,10171,,22032331,11341139,809765,21062748,10531374,
2021-09-21,31335,11205,16978,,22063666,11352079,803976,21096206,10548103,
2021-09-22,41791,14812,22914,,22105457,11366595,795853,21141484,10570742,
2021-09-23,47201,16129,26016,,22152658,11382461,785947,21193028,10596514,
2021-09-24,46277,15627,26632,,22198935,11397827,774923,21245808,10622904,
2021-09-25,48168,15246,29931,,22247103,11412820,760219,21305202,10652601,
2021-09-26,37477,12415,24471,,22284580,11424960,748142,21353636,10676818,
2021-09-27,19145,6527,12312,,22303725,11431233,742341,21377784,10688892,
2021-09-28,30930,11285,17864,,22334655,11442259,735750,21413018,10706509,
2021-09-29,37860,12468,21710,,22372515,11454456,726488,21455936,10727968,
2021-09-30,37314,11646,21360,,22409829,11465843,716755,21498176,10749088,
2021-10-01,30853,9804,18398,,22440682,11475421,708148,21534546,10767273,
2021-10-02,37113,11150,23572,,22477795,11486301,695708,21581186,10790593,
2021-10-03,27198,8161,18321,,22504993,11494221,685535,21617372,10808686,
2021-10-04,14864,4744,9801,,22519857,11498719,680460,21636518,10818259,
2021-10-05,26792,8584,15852,,22546649,11507042,673177,21667730,10833865,
2021-10-06,31640,9632,18494,,22578289,11516415,664307,21704216,10852108,
2021-10-07,30330,9388,17111,,22608619,11525552,656571,21737962,10868981,
2021-10-08,32814,10735,18839,,22641433,11536017,648454,21775126,10887563,
2021-10-09,34114,10653,21001,,22675547,11546407,638092,21816630,10908315,
2021-10-10,23393,7654,15075,,22698940,11553810,630659,21846302,10923151,
2021-10-11,11997,3837,7862,,22710937,11557397,626618,21861558,10930779,
2021-10-12,5093,1622,3257,,22716030,11558741,624968,21867546,10933773,
2021-10-13,29088,9188,18072,,22745118,11567639,616068,21903142,10951571,
2021-10-14,28996,8900,17738,,22774114,11576264,607220,21938088,10969044,
2021-10-15,29068,8819,18153,,22803182,11584820,597873,21973894,10986947,
2021-10-16,31127,8982,19865,,22834309,11593511,586978,22013066,11006533,
2021-10-17,23689,7256,15363,,22857998,11600513,578858,22043310,11021655,
2021-10-18,12301,3747,8144,,22870299,11603979,574449,22059060,11029530,
2021-10-19,21246,6618,12618,,22891545,11610315,568436,22083758,11041879,
2021-10-20,25630,7534,14900,,22917175,11617602,561057,22113090,11056545,
2021-10-21,23153,6674,13020,,22940328,11624007,554700,22138614,11069307,
2021-10-22,26095,7305,15097,,22966423,11630990,546892,22168196,11084098,
2021-10-23,28158,7599,17146,,22994581,11638327,537338,22201978,11100989,
2021-10-24,19337,5729,12588,,23013918,11643800,530467,22226666,11113333,
2021-10-25,9922,2710,6473,,23023840,11646241,526696,22239090,11119545,
2021-10-26,18888,5386,11089,,23042728,11651349,520984,22260730,11130365,
2021-10-27,22829,6071,13197,,23065557,11657165,513844,22286642,11143321,
2021-10-28,22285,5791,12631,,23087842,11662668,506993,22311350,11155675,
2021-10-29,22793,5727,13038,,23110635,11668094,499668,22336852,11168426,
2021-10-30,24083,6032,14598,,23134718,11673854,491090,22365528,11182764,
2021-10-31,16463,4592,10588,,23151181,11678152,485089,22386126,11193063,
2021-11-01,7863,2078,5053,,23159044,11679950,482101,22395698,11197849,
2021-11-02,15611,4362,7735,,23174655,11684021,478717,22410608,11205304,
2021-11-03,18604,5065,9596,,23193259,11688783,474176,22429214,11214607,
2021-11-04,19482,4867,10018,,23212741,11693374,469010,22448728,11224364,
2021-11-05,21440,4396,9511,,23234181,11697481,463881,22467200,11233600,
2021-11-06,25314,5199,12148,,23259495,11702411,456915,22490992,11245496,
2021-11-07,21430,4019,8909,,23280925,11706150,452013,22508274,11254137,
2021-11-08,11987,2109,4729,,23292912,11707964,449377,22517174,11258587,
2021-11-09,24102,3846,7635,,23317014,11711489,445578,22531822,11265911,
2021-11-10,28453,4503,8981,,23345467,11715714,441086,22549256,11274628,
2021-11-11,28736,4298,9084,,23374203,11719716,436291,22566850,11283425,
2021-11-12,26720,4161,8218,,23400923,11723586,432220,22582732,11291366,
2021-11-13,34283,5072,11397,,23435206,11728352,425886,22604932,11302466,
2021-11-14,23209,3898,8597,,23458415,11731987,421180,22621614,11310807,
2021-11-15,12695,2185,4490,,23471110,11733912,418867,22630090,11315045,
2021-11-16,26155,3925,7469,,23497265,11737580,415319,22644522,11322261,
2021-11-17,31140,4046,7795,,23528405,11741344,411560,22659568,11329784,
2021-11-18,32470,3855,7507,,23560875,11744893,407894,22673998,11336999,
2021-11-19,35444,3857,7739,,23596319,11748450,404000,22688900,11344450,
2021-11-20,40096,4379,8807,,23636415,11752550,399563,22705974,11352987,
2021-11-21,28102,3431,6941,,23664517,11755719,396039,22719360,11359680,
2021-11-22,14890,1949,3890,,23679407,11757392,394092,22726600,11363300,
2021-11-23,33041,3271,6002,,23712448,11760383,391353,22738060,11369030,
2021-11-24,42624,3752,6787,,23755072,11763831,388307,22751048,11375524,
2021-11-25,46018,3931,6555,,23801090,11767487,385680,22763614,11381807,
2021-11-26,52816,11342,6606,,23853906,11778559,390409,22776300,11388150,
2021-11-27,63492,22349,7023,,23917398,11800627,405725,22789804,11394902,
2021-11-28,51446,27738,5308,,23968844,11828073,428143,22799860,11399930,
2021-11-29,33517,18932,2876,,24002361,11846744,444188,22805112,11402556,
2021-11-30,55995,20669,5119,,24058356,11867132,459728,22814808,11407404,
2021-12-01,69516,26235,5622,,24127872,11893061,480327,22825468,11412734,
2021-12-02,71603,26483,5024,,24199475,11919246,501773,22834946,11417473,
2021-12-03,73391,25097,5155,,24272866,11944047,521709,22844676,11422338,
2021-12-04,81128,27783,6056,47270,24353994,11971537,543427,,11428110,807377
2021-12-05,62612,31926,4400,26266,24416606,12003168,570945,,11432223,833539
2021-12-06,38617,19141,2708,16752,24455223,12022020,587371,,11434649,850213
2021-12-07,60259,14846,4457,40943,24515482,12036595,597750,,11438845,891082
2021-12-08,73428,19053,4673,49700,24588910,12055371,612120,,11443251,940704
2021-12-09,74474,18271,4332,51852,24663384,12073333,626051,,11447282,992471
2021-12-10,77454,17587,4641,55218,24740838,12090639,638992,,11451647,1047608
2021-12-11,83154,20402,5816,56924,24823992,12110752,653564,,11457188,1104446
2021-12-12,60740,22696,4150,33852,24884732,12133168,672104,,11461064,1138209
2021-12-13,34917,11596,2405,20893,24919649,12144467,681285,,11463182,1159007
2021-12-14,101946,8997,3854,89052,25021595,12153154,686413,,11466741,1247939
2021-12-15,127665,12428,4499,110703,25149260,12165278,694332,,11470946,1358542
2021-12-16,139314,12452,4237,122612,25288574,12177444,702537,,11474907,1481055
2021-12-17,159136,12396,4504,142213,25447710,12189565,710420,,11479145,1623171
2021-12-18,175557,13521,4915,157078,25623267,12202792,719014,,11483778,1780154
2021-12-19,140409,18154,3928,118294,25763676,12220645,733232,,11487413,1898337
2021-12-20,106808,10305,2742,93716,25870484,12230682,740785,,11489897,1991955
2021-12-21,215203,12962,4306,197913,26085687,12243328,749434,,11493894,2189747
2021-12-22,237189,14419,5191,217694,26322876,12257449,758648,,11498801,2407324
2021-12-23,257396,11712,5075,240516,26580272,12268857,765279,,11503578,2647734
2021-12-24,223370,9443,4554,209311,26803642,12278003,770164,,11507839,2856929
2021-12-25,89689,3884,2501,83316,26893331,12281612,771542,,11510070,2940138
2021-12-26,11892,387,355,11140,26905223,12281707,771566,,11510141,2951148
2021-12-27,46925,1493,1111,44291,26952148,12282955,771941,,11511014,2995319
2021-12-28,144751,6099,3998,134595,27096899,12288760,774031,,11514729,3129783
2021-12-29,175446,9373,4571,161431,27272345,12297838,778829,,11519009,3291087
2021-12-30,200024,10127,5339,184516,27472369,12307662,783602,,11524060,3475469
2021-12-31,195177,10007,5792,179127,27667546,12317380,787808,,11529572,3654470
2022-01-01,96934,5378,3874,87357,27764480,12322449,789304,,11533145,3741678
2022-01-02,19436,939,924,17444,27783916,12323097,789310,,11533787,3758976
2022-01-03,88242,4772,4590,78799,27872158,12327559,789484,,11538075,3837622
2022-01-04,146343,5996,5312,134995,28018501,12333227,790155,,11543072,3972461
2022-01-05,177455,7617,7292,162374,28195956,12340490,790469,,11550021,4134675
2022-01-06,191492,7199,6781,176987,28387448,12347370,790876,,11556494,4311507
2022-01-07,191212,7951,6986,175465,28578660,12354977,791829,,11563148,4486799
2022-01-08,181624,8615,6630,165194,28760284,12363260,793801,,11569459,4651837
2022-01-09,131083,9862,7175,113953,28891367,12372800,796483,,11576317,4765630
2022-01-10,90550,5107,4489,80826,28981917,12377585,797091,,11580494,4846303
2022-01-11,138843,6149,6561,125427,29120760,12383387,796666,,11586721,4971540
2022-01-12,156990,8155,8046,138667,29277750,12391213,796770,,11594443,5110039
2022-01-13,162644,9205,9207,141523,29440394,12400056,796754,,11603302,5251379
2022-01-14,159829,10745,10371,136023,29600223,12410440,797123,,11613317,5387204
2022-01-15,161178,11008,11668,135868,29761401,12421078,796452,,11624626,5522879
2022-01-16,109758,9285,9669,89449,29871159,12430002,796061,,11633941,5612111
2022-01-17,65771,5934,6562,52635,29936930,12435601,795423,,11640178,5664561
2022-01-18,36088,2003,2124,31139,29973018,12437249,795291,,11641958,5695504
2022-01-19,101298,5580,6713,85945,30074316,12442429,794140,,11648289,5781222
2022-01-20,103575,6321,6998,85719,30177891,12448366,793455,,11654911,5866718
2022-01-21,102078,6228,8053,82484,30279969,12454190,791616,,11662574,5948974
2022-01-22,102558,8710,12067,78104,30382527,12462511,788252,,11674259,6026850
2022-01-23,76672,7305,13985,54782,30459199,12469473,781565,,11687908,6081410
2022-01-24,42255,3194,7934,30738,30501454,12472303,776807,,11695496,6111941
2022-01-25,62554,3756,8365,48114,30564008,12475681,772183,,11703498,6159837
2022-01-26,77869,4911,13165,55686,30641877,12480215,763924,,11716291,6215281
2022-01-27,78056,4893,13244,56034,30719933,12484736,755563,,11729173,6271078
2022-01-28,77265,4671,13671,53883,30797198,12489049,746550,,11742499,6324742
2022-01-29,84799,5528,17706,58103,30881997,12494214,734365,,11759849,6382601
2022-01-30,66489,5025,20621,40149,30948486,12498897,718755,,11780142,6422525
2022-01-31,34738,2175,9879,22345,30983224,12500753,711042,,11789711,6444681
2022-02-01,51340,3267,9658,36520,31034564,12503667,704641,,11799026,6480976
2022-02-02,57698,3844,12391,38677,31092262,12507181,696079,,11811102,6519454
2022-02-03,52571,3610,11506,34297,31144833,12510414,688171,,11822243,6553500
2022-02-04,43074,2947,10555,27276,31187907,12513051,680553,,11832498,6580582
2022-02-05,58703,3737,14469,37558,31246610,12516456,669809,,11846647,6617927
2022-02-06,49852,3638,16113,29571,31296462,12519771,657329,,11862442,6647274
2022-02-07,23226,1691,7807,13436,31319688,12521136,651200,,11869936,6660486
2022-02-08,33374,2353,7240,21965,31353062,12523159,646306,,11876853,6682218
2022-02-09,38866,2781,8912,24406,31391928,12525582,640169,,11885413,6706372
2022-02-10,37528,2763,8831,22549,31429456,12528009,634097,,11893912,6728691
2022-02-11,39432,2721,10287,22999,31468888,12530384,626522,,11903862,6751452
2022-02-12,42032,2954,11452,25309,31510920,12533004,618013,,11914991,6776537
2022-02-13,36306,2801,13138,19939,31547226,12535518,607673,,11927845,6796278
2022-02-14,16967,1175,6118,9466,31564193,12536418,602722,,11933696,6805544
2022-02-15,19341,1384,4743,11874,31583534,12537479,599353,,11938126,6817191
2022-02-16,26011,1764,7727,14945,31609545,12538946,593386,,11945560,6831935
2022-02-17,26751,1681,7518,14983,31636296,12540272,587540,,11952732,6846663
2022-02-18,23929,1353,6604,13671,31660225,12541308,582277,,11959031,6860125
2022-02-19,37830,1902,8335,26050,31698055,12542879,575839,,11967040,6885934
2022-02-20,32563,1493,7959,22803,31730618,12544072,569365,,11974707,6908533
2022-02-21,17499,913,3677,12755,31748117,12544690,566592,,11978098,6921077
2022-02-22,9099,428,1549,6953,31757216,12544829,565466,,11979363,6927820
2022-02-23,25325,1327,4789,17290,31782541,12545846,561997,,11983849,6944874
2022-02-24,24562,1398,5233,15476,31807103,12546923,558158,,11988765,6960107
2022-02-25,23090,1387,5135,14503,31830193,12548016,554403,,11993613,6974384
2022-02-26,25221,1383,5908,16551,31855414,12549089,549871,,11999218,6990709
2022-02-27,26948,1369,7365,17700,31882362,12550189,543864,,12006325,7008214
2022-02-28,10127,594,2529,6745,31892489,12550530,541921,,12008609,7014776
2022-03-01,13183,943,3147,8161,31905672,12551168,539707,,12011461,7022720
2022-03-02,15407,1163,3575,9614,31921079,12552070,537288,,12014782,7032157
2022-03-03,14292,1077,3224,8686,31935371,12552836,535134,,12017702,7040612
2022-03-04,14464,989,3441,8313,31949835,12553504,532678,,12020826,7048672
2022-03-05,18526,1276,4996,11181,31968361,12554471,528947,,12025524,7059629
2022-03-06,16507,1087,5522,9602,31984868,12555279,524506,,12030773,7069024
2022-03-07,5943,464,1858,3509,31990811,12555458,523105,,12032353,7072316
2022-03-08,7354,697,1937,4158,31998165,12555877,521858,,12034019,7076275
2022-03-09,11152,906,2735,6404,32009317,12556507,520023,,12036484,7082477
2022-03-10,12752,1044,3251,6834,32022069,12557274,517809,,12039465,7089098
2022-03-11,12882,903,3406,6862,32034951,12557888,515298,,12042590,7095744
2022-03-12,14677,1045,4178,8310,32049628,12558661,512162,,12046499,7103850
2022-03-13,14740,1089,4997,8329,32064368,12559459,508250,,12051209,7111942
2022-03-14,6329,448,2228,3497,32070697,12559637,506467,,12053170,7115225
2022-03-15,10195,791,2624,5972,32080892,12560138,504622,,12055516,7120983
2022-03-16,13049,932,3660,6950,32093941,12560782,501891,,12058891,7127703
2022-03-17,13179,1047,3957,6755,32107120,12561542,498974,,12062568,7134239
2022-03-18,11901,911,3144,6432,32119021,12562151,496731,,12065420,7140448
2022-03-19,14434,1002,4161,7899,32133455,12562874,493570,,12069304,7148129
2022-03-20,11737,989,3955,6367,32145192,12563592,490599,,12072993,7154288
2022-03-21,5056,414,1589,2813,32150248,12563747,489420,,12074327,7156898
2022-03-22,6700,551,1556,3886,32156948,12564012,488410,,12075602,7160569
2022-03-23,9962,784,2296,5191,32166910,12564481,486895,,12077586,7165519
2022-03-24,9284,723,2375,4606,32176194,12564940,485234,,12079706,7169921
2022-03-25,9216,782,2151,4746,32185410,12565459,483857,,12081602,7174455
2022-03-26,10919,934,2831,5503,32196329,12566116,481958,,12084158,7179739
2022-03-27,10221,909,3537,5299,32206550,12566766,479326,,12087440,7184827
2022-03-28,3577,319,1107,1986,32210127,12566846,478535,,12088311,7186620
2022-03-29,5334,498,1208,2687,32215461,12567060,477819,,12089241,7189086
2022-03-30,7848,747,1833,4121,32223309,12567529,476728,,12090801,7192983
2022-03-31,8646,689,1924,4412,32231955,12567929,475487,,12092442,7197173
2022-04-01,9298,801,1911,4884,32241253,12568438,474368,,12094070,7201818
2022-04-02,10428,885,2208,5568,32251681,12569036,473033,,12096003,7207169
2022-04-03,9196,878,2567,5063,32260877,12569660,471338,,12098322,7212033
2022-04-04,4196,387,1005,2406,32265073,12569786,470717,,12099069,7214236
2022-04-05,6061,598,1034,3049,32271134,12570044,470275,,12099769,7217011
2022-04-06,8367,715,1478,4373,32279501,12570468,469507,,12100961,7221157
2022-04-07,10332,732,1685,4835,32289833,12570901,468549,,12102352,7225750
2022-04-08,23986,811,1580,4835,32313819,12571434,467774,,12103660,7230369
2022-04-09,30475,969,1972,5893,32344294,12572105,466762,,12105343,7236039
2022-04-10,24849,976,2387,5331,32369143,12572824,465345,,12107479,7241170
2022-04-11,12568,385,874,2432,32381711,12572960,464852,,12108108,7243401
2022-04-12,28109,691,1017,3535,32409820,12573349,464519,,12108830,7246704
2022-04-13,37770,851,1556,4927,32447590,12573901,463810,,12110091,7251401
2022-04-14,37883,761,1610,4910,32485473,12574351,462958,,12111393,7256059
2022-04-15,43393,1230,2101,6726,32528866,12575283,462083,,12113200,7262548
2022-04-16,8087,358,650,1736,32536953,12575381,461789,,12113592,7264068
2022-04-17,21004,870,1922,4315,32557957,12575967,460730,,12115237,7268160
2022-04-18,5457,305,462,1288,32563414,12575986,460568,,12115418,7269208
2022-04-19,22646,615,771,3100,32586060,12576320,460403,,12115917,7272089
2022-04-20,40324,1063,1394,4617,32626384,12577057,460069,,12116988,7276442
2022-04-21,38745,941,1601,4678,32665129,12577703,459401,,12118302,7280886
2022-04-22,35612,1011,1428,4265,32700741,12578441,458977,,12119464,7284932
2022-04-23,34639,1004,1733,4711,32735380,12579163,458245,,12120918,7289406
2022-04-24,20805,1022,1882,3777,32756185,12579935,457382,,12122553,7292989
2022-04-25,8299,453,691,1707,32764484,12580119,457143,,12122976,7294480
2022-04-26,24602,732,942,3138,32789086,12580559,456927,,12123632,7297381
2022-04-27,33592,955,1368,3934,32822678,12581239,456506,,12124733,7301099
2022-04-28,32828,927,1412,3927,32855506,12581893,456012,,12125881,7304803
2022-04-29,32051,1098,1378,3908,32887557,12582694,455725,,12126969,7308483
2022-04-30,30273,923,1535,4020,32917830,12583320,455106,,12128214,7312267
2022-05-01,16746,768,1576,2969,32934576,12583792,454293,,12129499,7314994
2022-05-02,5933,309,524,1097,32940509,12583805,454074,,12129731,7315864
2022-05-03,20921,588,829,2345,32961430,12584088,453827,,12130261,7317970
2022-05-04,29412,800,1091,3293,32990842,12584579,453531,,12131048,7321014
2022-05-05,29091,872,1160,3125,33019933,12585139,453233,,12131906,7323895
2022-05-06,29081,1146,1279,2982,33049014,12585998,453095,,12132903,7326651
2022-05-07,28482,868,1260,3111,33077496,12586576,452698,,12133878,7329538
2022-05-08,15995,896,1309,2322,33093491,12587215,452283,,12134932,7331659
2022-05-09,5896,292,474,943,33099387,12587242,452095,,12135147,7332393
2022-05-10,21221,696,718,2119,33120608,12587621,452066,,12135555,7334253
2022-05-11,28940,836,1079,2654,33149548,12588126,451819,,12136307,7336635
2022-05-12,28230,800,1082,2509,33177778,12588629,451533,,12137096,7338903
2022-05-13,27591,878,1117,2469,33205369,12589197,451290,,12137907,7341115
2022-05-14,25685,808,1096,2608,33231054,12589689,450995,,12138694,7343468
2022-05-15,14844,751,1273,2055,33245898,12590170,450466,,12139704,7345306
2022-05-16,6381,325,532,1047,33252279,12590258,450255,,12140003,7346167
2022-05-17,19594,585,775,1741,33271873,12590529,450058,,12140471,7347660
2022-05-18,26538,877,1097,2272,33298411,12591142,449833,,12141309,7349717
2022-05-19,24430,682,1155,2159,33322841,12591557,449353,,12142204,7351659
2022-05-20,24260,801,1136,2215,33347101,12592091,449014,,12143077,7353657
2022-05-21,22395,691,1166,2345,33369496,12592474,448530,,12143944,7355761
2022-05-22,10555,551,888,1486,33380051,12592764,448188,,12144576,7357030
2022-05-23,4561,241,462,785,33384612,12592747,447965,,12144782,7357607
2022-05-24,2611,118,176,433,33387223,12592612,447905,,12144707,7357831
2022-05-25,19353,655,945,1952,33406576,12593002,447605,,12145397,7359574
2022-05-26,20635,662,948,1908,33427211,12593391,447313,,12146078,7361260
2022-05-27,21752,816,1057,2074,33448963,12593921,447069,,12146852,7363103
2022-05-28,19397,721,1164,2145,33468360,12594373,446623,,12147750,7365035
2022-05-29,12107,761,1280,1725,33480467,12594899,446097,,12148802,7366568
2022-05-30,4578,311,548,751,33485045,12594964,445857,,12149107,7367121
2022-05-31,13545,572,749,1666,33498590,12595234,445674,,12149560,7368547
2022-06-01,16606,702,970,1876,33515196,12595632,445404,,12150228,7370169
2022-06-02,14598,556,866,1673,33529794,12595876,445087,,12150789,7371601
2022-06-03,16098,697,1095,1813,33545892,12596297,444683,,12151614,7373197
2022-06-04,13315,648,1162,1842,33559207,12596689,444165,,12152524,7374838
2022-06-05,7866,587,1109,1432,33567073,12597027,443639,,12153388,7376078
2022-06-06,3293,206,444,641,33570366,12596987,443398,,12153589,7376520
2022-06-07,11210,474,725,1368,33581576,12597162,443142,,12154020,7377644
2022-06-08,14057,666,1012,1608,33595633,12597570,442791,,12154779,7379034
2022-06-09,13368,662,922,1673,33609001,12597944,442526,,12155418,7380475
2022-06-10,13847,685,1066,1695,33622848,12598343,442137,,12156206,7381940
2022-06-11,12976,613,1031,1864,33635824,12598671,441717,,12156954,7383582
2022-06-12,8094,644,1236,1500,33643918,12599059,441121,,12157938,7384877
2022-06-13,3186,284,422,709,33647104,12599077,440978,,12158099,7385377
2022-06-14,10125,511,666,1262,33657229,12599299,440817,,12158482,7386401
2022-06-15,13499,470,829,1620,33670728,12599476,440456,,12159020,7387786
2022-06-16,12534,493,855,1616,33683262,12599665,440089,,12159576,7389156
2022-06-17,11686,479,815,1652,33694948,12599859,439746,,12160113,7390574
2022-06-18,11445,436,873,1860,33706393,12600026,439306,,12160720,7392211
2022-06-19,6998,482,896,1420,33713391,12600260,438891,,12161369,7393421
2022-06-20,2286,147,301,643,33715677,12600187,438731,,12161456,7393896
2022-06-21,9538,358,614,1381,33725215,12600258,438470,,12161788,7395029
2022-06-22,13606,406,724,1702,33738821,12600392,438145,,12162247,7396506
2022-06-23,13694,400,773,1680,33752515,12600530,437769,,12162761,7397975
2022-06-24,15360,435,811,1671,33767875,12600705,437389,,12163316,7399431
2022-06-25,14464,424,851,1711,33782339,12600871,436951,,12163920,7400936
2022-06-26,8156,432,885,1280,33790495,12601045,436491,,12164554,7402002
2022-06-27,3211,171,364,593,33793706,12600968,436294,,12164674,7402389
2022-06-28,9615,370,556,1223,33803321,12601053,436104,,12164949,7403380
2022-06-29,13306,413,727,1628,33816627,12601177,435788,,12165389,7404769
2022-06-30,12223,482,845,1575,33828850,12601376,435423,,12165953,7406112
2022-07-01,13035,548,970,1947,33841885,12601669,434996,,12166673,7407854
2022-07-02,1609,110,115,362,33843494,12601503,434989,,12166514,7407984
2022-07-03,5158,261,493,958,33848652,12601509,434748,,12166761,7408728
2022-07-04,2756,131,279,614,33851408,12601394,434599,,12166795,7409146
2022-07-05,11139,372,598,1572,33862547,12601472,434365,,12167107,7410473
2022-07-06,15952,545,855,2007,33878499,12601723,434049,,12167674,7412239
2022-07-07,15656,521,831,1922,33894155,12601957,433738,,12168219,7413909
2022-07-08,17876,553,870,2244,33912031,12602206,433420,,12168786,7415904
2022-07-09,14133,449,596,1841,33926164,12602382,433272,,12169110,7417512
2022-07-10,8739,472,752,1501,33934903,12602608,432991,,12169617,7418808
2022-07-11,4093,199,331,870,33938996,12602542,432856,,12169686,7419458
2022-07-12,12104,413,523,1653,33951100,12602657,432741,,12169916,7420858
2022-07-13,16708,562,770,2141,33967808,12602924,432527,,12170397,7422757
2022-07-14,16856,486,674,2023,33984664,12603106,432328,,12170778,7424542
2022-07-15,28887,600,822,2181,34013551,12603406,432105,,12171301,7426482
2022-07-16,30286,584,771,2324,34043837,12603678,431909,,12171769,7428556
2022-07-17,22921,538,636,1882,34066758,12603980,431808,,12172172,7430245
2022-07-18,11389,187,254,852,34078147,12603899,431736,,12172163,7430875
2022-07-19,28943,592,590,2131,34107090,12604218,431735,,12172483,7432775
2022-07-20,37626,842,922,2587,34144716,12604783,431650,,12173133,7435127
2022-07-21,36348,732,810,2803,34181064,12605229,431565,,12173664,7437691
2022-07-22,35793,827,888,2681,34216857,12605771,431498,,12174273,7440136
2022-07-23,35138,820,913,2825,34251995,12606280,431397,,12174883,7442707
2022-07-24,21728,602,805,1768,34273723,12606621,431191,,12175430,7444252
2022-07-25,11932,308,311,1080,34285655,12606649,431183,,12175466,7445105
2022-07-26,26084,621,601,2209,34311739,12606988,431202,,12175786,7447072
2022-07-27,32461,810,844,2647,34344200,12607543,431166,,12176377,7449511
2022-07-28,31532,725,884,2603,34375732,12607975,431003,,12176972,7451867
2022-07-29,29986,1790,875,2640,34405718,12609475,431914,,12177561,7454258
2022-07-30,25821,2525,745,2431,34431539,12611727,433692,,12178035,7456462
2022-07-31,14291,1068,541,1561,34445830,12612530,434215,,12178315,7457798
2022-08-01,5911,336,223,681,34451741,12612608,434326,,12178282,7458256
2022-08-02,4473,305,135,600,34456214,12612643,434492,,12178151,7458634
2022-08-03,22927,2635,736,2234,34479141,12615005,436387,,12178618,7460635
2022-08-04,22222,2479,676,2128,34501363,12617159,438184,,12178975,7462502
2022-08-05,21788,2756,743,2063,34523151,12619636,440189,,12179447,7464339
2022-08-06,19641,2877,657,1990,34542792,12622205,442403,,12179802,7466074
2022-08-07,12697,2236,618,1418,34555489,12624169,444015,,12180154,7467277
2022-08-08,4766,570,188,603,34560255,12624457,444390,,12180067,7467648
2022-08-09,14004,1465,557,1589,34574259,12625638,445292,,12180346,7468998
2022-08-10,19119,2363,716,1988,34593378,12627729,446937,,12180792,7470759
2022-08-11,17073,2043,718,1851,34610451,12629499,448260,,12181239,7472380
2022-08-12,16979,2049,734,1850,34627430,12631262,449574,,12181688,7474003
2022-08-13,15945,2222,761,1805,34643375,12633205,451033,,12182172,7475572
2022-08-14,9523,1621,618,1081,34652898,12634539,452032,,12182507,7476419
2022-08-15,3868,388,268,477,34656766,12634676,452149,,12182527,7476689
2022-08-16,10801,1073,514,1355,34667567,12635451,452706,,12182745,7477795
2022-08-17,16091,1832,738,1778,34683658,12636997,453799,,12183198,7479338
2022-08-18,14924,1640,748,1688,34698582,12638316,454687,,12183629,7480758
2022-08-19,15305,1846,747,1544,34713887,12639888,455782,,12184106,7482070
2022-08-20,14277,1640,739,1543,34728164,12641240,456677,,12184563,7483376
2022-08-21,9894,1532,658,1163,34738058,12642511,457547,,12184964,7484326
2022-08-22,4162,481,270,561,34742220,12642696,457755,,12184941,7484634
2022-08-23,11128,1248,553,1492,34753348,12643640,458447,,12185193,7485875
2022-08-24,14751,1807,868,2185,34768099,12645179,459386,,12185793,7487832
2022-08-25,14026,1719,780,2119,34782125,12646613,460318,,12186295,7489708
2022-08-26,13923,1687,815,2090,34796048,12648011,461183,,12186828,7491553
2022-08-27,12409,1484,877,1996,34808457,12649172,461784,,12187388,7493285
2022-08-28,7921,1258,620,1396,34816378,12650176,462420,,12187756,7494466
2022-08-29,3394,504,283,681,34819772,12650408,462636,,12187772,7494921
2022-08-30,9902,1169,649,1853,34829674,12651224,463150,,12188074,7496475
2022-08-31,13505,1626,944,2310,34843179,12652567,463828,,12188739,7498548
2022-09-01,12899,1721,910,2137,34856078,12653997,464635,,12189362,7500443
2022-09-02,15041,1615,991,4919,34871119,12655342,465251,,12190091,7505141
2022-09-03,14708,1525,919,5513,34885827,12656596,465854,,12190742,7510429
2022-09-04,8660,1010,675,3234,34894487,12657350,466181,,12191169,7513447
2022-09-05,3550,321,229,1383,34898037,12657410,466270,,12191140,7514610
2022-09-06,2460,157,113,1127,34900497,12657321,466311,,12191010,7515534
2022-09-07,10921,1018,587,3491,34911418,12658049,466740,,12191309,7518779
2022-09-08,10863,1021,523,2790,34922281,12658749,467235,,12191514,7521299
2022-09-09,9580,1013,488,2500,34931861,12659477,467755,,12191722,7523566
2022-09-10,10629,1266,551,3162,34942490,12660473,468464,,12192009,7526500
2022-09-11,9403,982,667,3734,34951893,12661212,468773,,12192439,7530029
2022-09-12,3124,295,203,1079,34955017,12661231,468859,,12192372,7530876
2022-09-13,6010,542,281,1131,34961027,12661496,469111,,12192385,7531773
2022-09-14,14476,798,432,1843,34975503,12661983,469473,,12192510,7533355
2022-09-15,15743,780,408,1533,34991246,12662451,469841,,12192610,7534623
2022-09-16,17748,766,445,1690,35008994,12662964,470156,,12192808,7536097
2022-09-17,17606,722,456,1665,35026600,12663391,470418,,12192973,7537514
2022-09-18,11207,776,451,1684,35037807,12663912,470741,,12193171,7538980
2022-09-19,4977,403,288,670,35042784,12664051,470853,,12193198,7539440
2022-09-20,13749,438,327,941,35056533,12664182,470962,,12193220,7540121
2022-09-21,23023,644,406,1496,35079556,12664534,471195,,12193339,7541375
2022-09-22,22901,638,397,1378,35102457,12664874,471430,,12193444,7542498
2022-09-23,22934,726,599,1416,35125391,12665309,471553,,12193756,7543667
2022-09-24,21677,736,689,1498,35147068,12665756,471596,,12194160,7544932
2022-09-25,11314,595,702,1355,35158382,12666079,471484,,12194595,7546058
2022-09-26,4561,192,218,594,35162943,12665990,471452,,12194538,7546413
2022-09-27,37644,499,364,1498,35200587,12666229,471583,,12194646,7547691
2022-09-28,50955,730,670,1901,35251542,12666700,471642,,12195058,7549375
2022-09-29,47990,637,739,1836,35299532,12667029,471533,,12195496,7550944
2022-09-30,47265,679,806,2001,35346797,12667389,471404,,12195985,7552671
2022-10-01,34434,527,632,1545,35381231,12667617,471297,,12196320,7553958
2022-10-02,24238,738,1025,1710,35405469,12668073,471007,,12197066,7555426
2022-10-03,10863,239,230,611,35416332,12668032,471012,,12197020,7555808
2022-10-04,32180,478,458,1168,35448512,12668202,471028,,12197174,7556710
2022-10-05,40417,625,740,1558,35488929,12668526,470908,,12197618,7558016
2022-10-06,38675,609,652,1567,35527604,12668846,470863,,12197983,7559333
2022-10-07,42229,660,851,1742,35569833,12669172,470664,,12198508,7560785
2022-10-08,37379,784,1145,2120,35607212,12669646,470297,,12199349,7562647
2022-10-09,18811,549,727,1557,35626023,12669934,470116,,12199818,7563982
2022-10-10,6862,170,370,567,35632885,12669820,469914,,12199906,7564302
2022-10-11,4986,124,111,318,35637871,12669666,469922,,12199744,7564390
2022-10-12,35098,579,684,1426,35672969,12669924,469815,,12200109,7565539
2022-10-13,36747,644,857,1621,35709716,12670225,469600,,12200625,7566868
2022-10-14,36959,621,752,1539,35746675,12670532,469466,,12201066,7568138
2022-10-15,35444,716,1013,1624,35782119,12670980,469166,,12201814,7569534
2022-10-16,20660,654,1024,1593,35802779,12671380,468790,,12202590,7570907
2022-10-17,7349,206,477,538,35810128,12671316,468518,,12202798,7571215
2022-10-18,36413,458,499,1397,35846541,12671467,468473,,12202994,7572350
2022-10-19,49872,619,729,1983,35896413,12671797,468360,,12203437,7574092
2022-10-20,51264,623,648,2048,35947677,12672119,468333,,12203786,7575887
2022-10-21,52835,699,618,1938,36000512,12672506,468411,,12204095,7577565
2022-10-22,50853,752,905,2308,36051365,12672941,468253,,12204688,7579607
2022-10-23,30622,579,782,2118,36081987,12673218,468044,,12205174,7581470
2022-10-24,14130,231,270,979,36096117,12673163,468000,,12205163,7582203
2022-10-25,41343,474,488,1815,36137460,12673309,467983,,12205326,7583739
2022-10-26,51615,618,660,2122,36189075,12673605,467937,,12205668,7585592
2022-10-27,50091,610,768,2162,36239166,12673905,467773,,12206132,7587495
2022-10-28,49773,591,673,2093,36288939,12674156,467688,,12206468,7589293
2022-10-29,50579,737,778,2217,36339518,12674565,467643,,12206922,7591228
2022-10-30,28386,663,930,2034,36367904,12674966,467373,,12207593,7593032
2022-10-31,12436,199,234,777,36380340,12674908,467335,,12207573,7593592
2022-11-01,33072,341,196,1220,36413412,12674921,467474,,12207447,7594534
2022-11-02,44270,576,622,1905,36457682,12675191,467426,,12207765,7596161
2022-11-03,44172,540,605,1856,36501854,12675432,467358,,12208074,7597756
2022-11-04,44624,652,527,2024,36546478,12675800,467477,,12208323,7599541
2022-11-05,45189,648,755,2369,36591667,12676172,467367,,12208805,7601665
2022-11-06,26012,560,771,2096,36617679,12676414,467154,,12209260,7603484
2022-11-07,10710,243,235,876,36628389,12676409,467159,,12209250,7604154
2022-11-08,33463,487,395,1584,36661852,12676629,467248,,12209381,7605512
2022-11-09,40521,605,569,1966,36702373,12676947,467283,,12209664,7607234
2022-11-10,39161,626,547,1926,36741534,12677284,467358,,12209926,7608909
2022-11-11,43324,638,641,2205,36784858,12677638,467354,,12210284,7610869
2022-11-12,36832,640,592,2185,36821690,12677976,467394,,12210582,7612791
2022-11-13,24257,559,770,2276,36845947,12678263,467178,,12211085,7614833
2022-11-14,10961,233,204,1023,36856908,12678230,467206,,12211024,7615622
2022-11-15,33583,485,379,1691,36890491,12678388,467308,,12211080,7617036
2022-11-16,43517,801,581,2369,36934008,12678919,467523,,12211396,7619178
2022-11-17,38314,674,646,2241,36972322,12679275,467547,,12211728,7621148
2022-11-18,40600,725,530,2326,37012922,12679683,467738,,12211945,7623197
2022-11-19,39640,1016,1031,3077,37052562,12680388,467719,,12212669,7626000
2022-11-20,22411,661,718,2440,37074973,12680813,467661,,12213152,7628242
2022-11-21,8918,197,192,970,37083891,12680773,467662,,12213111,7629025
2022-11-22,26429,480,368,1512,37110320,12680939,467770,,12213169,7630263
2022-11-23,32052,686,666,2068,37142372,12681324,467788,,12213536,7632076
2022-11-24,31891,664,750,2081,37174263,12681705,467701,,12214004,7633917
2022-11-25,30745,764,829,1949,37205008,12682195,467630,,12214565,7635636
2022-11-26,30270,907,1190,2696,37235278,12682801,467340,,12215461,7638070
2022-11-27,18670,611,944,2087,37253948,12683145,467003,,12216142,7639925
2022-11-28,7536,191,280,786,37261484,12683073,466909,,12216164,7640476
2022-11-29,21014,421,452,1291,37282498,12683209,466875,,12216334,7641521
2022-11-30,27880,647,647,1838,37310378,12683579,466873,,12216706,7643117
2022-12-01,24793,594,682,1689,37335171,12683890,466783,,12217107,7644559
2022-12-02,25044,524,630,1771,37360215,12684131,466671,,12217460,7646081
2022-12-03,25541,588,779,1944,37385756,12684443,466473,,12217970,7647802
2022-12-04,15245,499,606,1699,37401001,12684659,466362,,12218297,7649248
2022-12-05,6879,168,156,746,37407880,12684573,466369,,12218204,7649776
2022-12-06,20332,421,351,1375,37428212,12684683,466438,,12218245,7650882
2022-12-07,24755,553,609,1668,37452967,12684978,466379,,12218599,7652327
2022-12-08,23148,563,523,1760,37476115,12685282,466418,,12218864,7653856
2022-12-09,23315,636,575,1631,37499430,12685654,466478,,12219176,7655263
2022-12-10,22565,512,600,1627,37521995,12685917,466389,,12219528,7656671
2022-12-11,14197,549,785,1567,37536192,12686258,466151,,12220107,7658054
2022-12-12,5506,150,157,593,37541698,12686173,466140,,12220033,7658450
2022-12-13,17786,378,367,1125,37559484,12686286,466151,,12220135,7659345
2022-12-14,21309,511,547,1452,37580793,12686583,466111,,12220472,7660609
2022-12-15,21950,530,601,1578,37602743,12686843,466039,,12220804,7661952
2022-12-16,16278,378,449,1030,37619021,12686963,465968,,12220995,7662761
2022-12-17,18690,559,506,1273,37637711,12687273,466020,,12221253,7663802
2022-12-18,12634,530,794,1303,37650345,12687576,465755,,12221821,7664899
2022-12-19,4585,133,115,448,37654930,12687449,465769,,12221680,7665116
2022-12-20,16201,501,449,1105,37671131,12687705,465818,,12221887,7666007
2022-12-21,18460,547,551,1298,37689591,12688022,465811,,12222211,7667100
2022-12-22,18586,576,589,1743,37708177,12688370,465798,,12222572,7668642
2022-12-23,15629,580,597,1712,37723806,12688671,465776,,12222895,7670120
2022-12-24,5329,223,171,671,37729135,12688651,465828,,12222823,7670569
2022-12-25,2441,153,152,480,37731576,12688564,465822,,12222742,7670840
2022-12-26,262,12,7,48,37731838,12688340,465823,,12222517,7670680
2022-12-27,2090,99,35,305,37733928,12688231,465885,,12222346,7670801
2022-12-28,8316,337,167,975,37742244,12688318,466053,,12222265,7671550
2022-12-29,13154,584,524,1600,37755398,12688652,466110,,12222542,7672930
2022-12-30,15811,671,657,1877,37771209,12689079,466121,,12222958,7674588
2022-12-31,11224,462,387,1353,37782433,12689262,466192,,12223070,7675694
2023-01-01,3905,204,219,561,37786338,12689227,466177,,12223050,7676045
2023-01-02,652,37,15,96,37786990,12689039,466199,,12222840,7675940
2023-01-03,8187,300,151,897,37795177,12689110,466343,,12222767,7676645
2023-01-04,14713,575,547,1545,37809890,12689461,466365,,12223096,7677993
2023-01-05,16105,653,533,1794,37825995,12689869,466482,,12223387,7679572
2023-01-06,18815,718,609,2044,37844810,12690364,466588,,12223776,7681417
2023-01-07,18516,708,638,2052,37863326,12690844,466655,,12224189,7683268
2023-01-08,11609,582,608,1630,37874935,12691221,466628,,12224593,7684714
2023-01-09,5298,216,196,664,37880233,12691207,466646,,12224561,7685180
2023-01-10,12155,419,315,781,37892388,12691384,466750,,12224634,7685745
2023-01-11,15536,459,370,1092,37907924,12691597,466837,,12224760,7686623
2023-01-12,14054,449,407,972,37921978,12691795,466878,,12224917,7687373
2023-01-13,14156,424,345,1036,37936134,12692021,466956,,12225065,7688226
2023-01-14,13368,479,452,1075,37949502,12692272,466980,,12225292,7689093
2023-01-15,9040,466,506,1049,37958542,12692536,466939,,12225597,7689970
2023-01-16,3744,148,130,479,37962286,12692461,466957,,12225504,7690245
2023-01-17,8848,270,179,651,37971134,12692459,467048,,12225411,7690664
2023-01-18,10237,352,273,756,37981371,12692581,467127,,12225454,7691208
2023-01-19,10578,318,318,760,37991949,12692666,467123,,12225543,7691767
2023-01-20,9823,319,272,716,38001772,12692761,467169,,12225592,7692278
2023-01-21,11301,358,398,904,38013073,12692899,467129,,12225770,7692993
2023-01-22,7565,346,404,816,38020638,12693036,467069,,12225967,7693616
2023-01-23,3379,144,131,288,38024017,12692998,467082,,12225916,7693744
2023-01-24,8277,228,165,549,38032294,12692979,467143,,12225836,7694075
2023-01-25,10309,349,296,660,38042603,12693109,467195,,12225914,7694544
2023-01-26,6720,236,203,469,38049323,12693119,467228,,12225891,7694820
2023-01-27,6900,241,197,491,38056223,12693119,467271,,12225848,7695104
2023-01-28,9333,312,337,693,38065556,12693205,467242,,12225963,7695599
2023-01-29,5958,235,341,689,38071514,12693214,467131,,12226083,7696085
2023-01-30,1899,89,79,216,38073413,12693089,467139,,12225950,7696108
2023-01-31,5869,156,150,413,38079282,12692995,467143,,12225852,7696296
2023-02-01,7288,251,248,488,38086570,12693047,467146,,12225901,7696610
2023-02-02,6462,295,239,499,38093032,12693150,467200,,12225950,7696949
2023-02-03,6539,197,191,462,38099571,12693146,467205,,12225941,7697231
2023-02-04,6711,232,305,540,38106282,12693194,467127,,12226067,7697614
2023-02-05,4173,198,291,483,38110455,12693176,467033,,12226143,7697915
2023-02-06,1834,91,98,211,38112289,12693052,467024,,12226028,7697928
2023-02-07,4960,162,181,383,38117249,12692985,467003,,12225982,7698113
2023-02-08,5766,214,206,429,38123015,12693004,467010,,12225994,7698367
2023-02-09,6113,214,243,438,38129128,12693020,466981,,12226039,7698635
2023-02-10,5076,158,207,369,38134204,12693029,466930,,12226099,7698873
2023-02-11,6049,185,258,458,38140253,12693006,466853,,12226153,7699142
2023-02-12,4076,217,343,408,38144329,12693027,466724,,12226303,7699371
2023-02-13,1480,56,87,146,38145809,12692904,466693,,12226211,7699367
2023-02-14,3936,132,179,308,38149745,12692819,466645,,12226174,7699480
2023-02-15,4537,119,191,285,38154282,12692751,466573,,12226178,7699600
2023-02-16,4912,174,285,400,38159194,12692724,466460,,12226264,7699819
2023-02-17,4978,180,210,342,38164172,12692723,466429,,12226294,7700003
2023-02-18,5111,230,295,487,38169283,12692766,466362,,12226404,7700324
2023-02-19,3349,133,243,373,38172632,12692717,466251,,12226466,7700544
2023-02-20,1419,64,54,157,38174051,12692611,466259,,12226352,7700555
2023-02-21,911,25,14,106,38174962,12692487,466268,,12226219,7700526
2023-02-22,4132,130,213,370,38179094,12692453,466180,,12226273,7700760
2023-02-23,4261,163,231,389,38183355,12692405,466106,,12226299,7700960
2023-02-24,3026,138,229,273,38186381,12692386,466013,,12226373,7701088
2023-02-25,5011,214,539,384,38191392,12692425,465688,,12226737,7701327
2023-02-26,3472,146,681,384,38194864,12692396,465152,,12227244,7701557
2023-02-27,1068,37,57,97,38195932,12692281,465129,,12227152,7701526
2023-02-28,2719,97,163,231,38198651,12692181,465061,,12227120,7701579
2023-03-01,3845,137,428,334,38202496,12692125,464769,,12227356,7701735
2023-03-02,4584,159,495,326,38207080,12692096,464430,,12227666,7701905
2023-03-03,4362,160,357,333,38211442,12692093,464231,,12227862,7702089
2023-03-04,4954,207,623,348,38216396,12692145,463813,,12228332,7702300
2023-03-05,2532,110,449,251,38218928,12692110,463473,,12228637,7702422
2023-03-06,1156,49,37,113,38220084,12692014,463483,,12228531,7702405
2023-03-07,3201,89,171,220,38223285,12691928,463399,,12228529,7702474
2023-03-08,4309,132,412,283,38227594,12691910,463118,,12228792,7702622
2023-03-09,4607,170,451,312,38232201,12691933,462833,,12229100,7702810
2023-03-10,3927,101,136,255,38236128,12691900,462796,,12229104,7702948
2023-03-11,4043,142,169,282,38240171,12691921,462768,,12229153,7703117
2023-03-12,2882,109,234,301,38243053,12691893,462640,,12229253,7703297
2023-03-13,857,32,32,103,38243910,12691813,462638,,12229175,7703300
2023-03-14,3053,101,109,255,38246963,12691783,462630,,12229153,7703442
2023-03-15,4073,143,162,306,38251036,12691821,462611,,12229210,7703649
2023-03-16,3997,173,234,274,38255033,12691848,462548,,12229300,7703804
2023-03-17,4268,171,202,306,38259301,12691894,462514,,12229380,7704000
2023-03-18,4346,144,194,295,38263647,12691919,462464,,12229455,7704190
2023-03-19,2714,129,233,255,38266361,12691970,462360,,12229610,7704375
2023-03-20,772,31,19,73,38267133,12691903,462372,,12229531,7704356
2023-03-21,2876,73,84,197,38270009,12691878,462357,,12229521,7704469
2023-03-22,3870,129,132,245,38273879,12691906,462354,,12229552,7704623
2023-03-23,3786,118,171,224,38277665,12691949,462299,,12229650,7704782
2023-03-24,3653,104,115,234,38281318,12691985,462288,,12229697,7704953
2023-03-25,4227,107,172,246,38285545,12692026,462221,,12229805,7705146
2023-03-26,2458,117,210,197,38288003,12692103,462128,,12229975,7705305
2023-03-27,902,50,32,65,38288905,12692132,462146,,12229986,7705352
2023-03-28,3009,88,77,197,38291914,12692211,462157,,12230054,7705540
2023-03-29,4080,133,136,214,38295994,12692344,462154,,12230190,7705754
2023-03-30,3654,118,162,197,38299648,12692462,462110,,12230352,7705951
